$ANSIBLE_VAULT;1.1;AES256
31643937343732643838363733353863393036663638363534396232633938363538356532643335
3331663137623462323962306639393036613165323263630a343634636539376564636135316464
39666539343465303037333134636461356538323230373434666236623461383232653733356630
3437393335626166620a636136306234623433633836383466646562313333643634633738333538
35636363626265633636303065666232346437366232353239363364643132323534636139303663
61636434333837623634643164643362343436616434376136346335633532663365393866396463
39336464313862623166353238393963363739376665663939386166323463323563386237363262
37663637366165646538353866396161616530346230313431366233346165663934343633383633
65303466653263636365393761303164346566633033663864396662633564653733383363393964
65396336633032316136643733643962626335613362646535353738613139323432633863643866
61636134323437376534666633346363323633626361636166613236313534646238313365633330
39343434376135346262623265373234326237376435316139303236643334656536323333353063
30666230633936633661343266663830623931353638346631306365333532623238626536663438
37333838333139376531656634323330633439313437656635353162663962623736636465666139
33613533336665353936303030623530656632633636393133353734356534323163643634653366
35383938383061613662663330386439393337363263653966623339363166336665313664356631
35633439616539613035333364323433333063346465653233356335386133323562393165303537
37343032663136383536336130636539373732356337333961343730383861343530373735313965
37313134373937346533663432316562613462306234626238663265313163353536613362656461
38646137383036633730613963643436363937663765306265366562313464663562383662613261
36323434326165333130323338666666306537383638616266633065623737316539306432363662
32313566613436653333316133333765626630343034366430396535393130383466366131306366
66643531306266333532623133366365316366633039346438653063613739393035616238656337
32633363623262633233343138616461643332316632313561393439666166393562353032366263
66616630346532653362633961663762666562376434666161393132363936643762653439353362
34656236653734656465313936333437323134643235376137363035333730613234343237643065
63633633636663363134363463643334363063613038336364653238333061636362383164336132
31626436363736663836333139323961303736653039373935613462646263303662373263353966
66633966366231636239373263363332306362363263383861363138636562663332383461343437
65646164366633373532326631333239613738623435653362613332343462326539316138376161
30346261383461373436376639666665346532386662396137396462356265376538303133313837
35343033353730316539343261323834626137363232356237616630373962363761383263643462
39663835393435636530303532383062626438663231343037313030303463363238326435346639
38366566303534366135323131623439363732356538323332343239613365353738333262646432
33376133626532316637343530353966383330306330623537303862333964363666373833366539
35613064666631346264396438343433366365366633336638356564323464373739663861633737
3631
